{
  "maze": [
    ["#","#","#","#","#","#","#","#","#","#","#","S","#","#","#"],
    ["#"," ","G","T","G","#"," "," "," "," "," "," "," "," ","#"],
    ["#","#","#","G","#","#","#"," ","#","#","#","#","#","#","#"],
    ["#"," ","T"," "," "," ","#"," "," "," ","#"," ","#","G","#"],
    ["#","#","#"," ","#"," ","#","#","#"," ","#"," ","#","G","#"],
    ["#"," ","G"," ","#"," ","#","G"," "," "," "," ","G","T","#"],
    ["#","#","#"," ","#"," ","#","#","#","#","#","T","#","T","#"],
    ["#"," ","#"," ","#"," ","#"," "," "," "," "," ","#"," ","#"],
    ["#","T","#"," ","#"," ","#","#","#"," ","#","#","#"," ","#"],
    ["#"," "," "," ","#"," "," "," "," "," "," "," ","#"," ","#"],
    ["#"," ","#","#","#","#","#","#","#","#","#","#","#","#","#"],
    ["#"," "," "," ","#","G","#"," ","T"," ","#","G","T"," ","#"],
    ["#","#","#"," ","#","T","#"," ","#","#","#","#","#"," ","#"],
    ["#"," "," "," "," ","L"," "," ","B"," "," "," ","T","G","#"],
    ["#","#","#","#","#","#","#","#","#","E","#","#","#","#","#"]
  ],
  "B":[11,13,9,15],
  "PlayerSkills":[[8,4],[2,0],[4,2],[6,3]],
  "C": [
    [5,-1,-1],
    [1,1]
  ],
  "L": "db6de5887d961f33f38d5d6c79ff706333f2274519c25db5bbded81393c3dfdb"
}